+-+-+-+-+-+-+-+-+-+-+-+-+-+-+-+-+-+-+-+-+-+-+-+-+-+-+-+-+-+-+-+-+-+-+-+-+-+-+-+-+-+-+-+-+-+-+-+-+-+-+
E     |       |   | |     |                   |   |             |   |     |     |         |   |     |
+-+-+ + +-+-+ + + + + +-+ + +-+ +-+-+-+-+ +-+ + + + +-+-+-+-+ +-+ + + +-+ +-+-+ +-+-+ +-+ + + + +-+ +
|   |   |       |   | | |   |       |   |   | | | |   |   |   |   |     |       |   | |   | |   |   |
+ + +-+-+ +-+-+-+-+-+ + +-+-+ +-+-+ + + +-+ + + + +-+ + +-+ +-+ +-+-+ + +-+-+-+-+ + + + +-+ +-+-+ +-+
| |       |   |     |   |     |   |   |   | | | |   | |     |     |   | |   |   | | | | |   |   |   |
+ +-+-+-+-+ +-+ +-+ + +-+ +-+ + + +-+-+-+ + +-+ +-+ + + +-+-+ + + +-+-+ + + + + + + +-+ + +-+ + +-+ +
| |   | |   |   | |     |   | | |     |   |     | |   |     | | |   |     | | | | |     | |   |   | |
+ + + + + +-+ +-+ + +-+-+-+ + + +-+-+ + +-+-+-+-+ +-+-+-+-+ + +-+-+ + +-+-+ + + + +-+-+-+ + +-+-+ + +
| | | | | |   | |   |       | |   |   | |     |     |       | |     | |     | | |   |   | |   | | | |
+ + + + + + +-+ +-+-+ +-+-+-+-+-+ +-+-+ + +-+ + +-+ + +-+-+-+ + +-+-+-+ +-+-+ + +-+ +-+ + +-+ + + + +
|   |     |   |       |         |     |   |   | |   |   |     | |   |   |     |   |     | |   | | | |
+-+ + +-+-+-+ + +-+-+-+-+-+ +-+-+-+-+ +-+-+ +-+ +-+-+-+ + +-+-+ + + + +-+-+-+-+-+ + +-+-+ + +-+ + + +
| | |     |   | |   |     | | |     |       | |         | |     | | | |   |         |     |   | | | |
+ + +-+-+ + +-+ + + + + +-+ + + +-+-+-+ +-+-+ +-+-+-+ +-+ + +-+-+ +-+ + + +-+-+ + +-+ +-+-+-+ + + + +
| |     | | |   | |   |   | | |     | |   | | |     |   | |     |     | | |     |     | |       |   |
+ + +-+ + + + +-+ +-+-+ + + + +-+-+ + +-+ + + +-+ + +-+ + +-+ + +-+-+-+ + + +-+-+-+-+-+ + +-+-+-+-+-+
|   |   |   |     |     | | |   | |       |       | | | | |   | |     | |   | |   |   |         |   |
+-+-+ +-+-+-+-+ +-+ +-+-+-+ +-+ + +-+ +-+-+-+-+-+-+ + + +-+ +-+ + +-+ + +-+-+ + + + + +-+ +-+ + +-+ +
|     |   |     | |   |       | |     |     |     |     |   | | | | |   | |   | | | |     |   |     |
+ + +-+ + +-+-+-+ +-+ + +-+-+-+ + +-+-+ +-+ + +-+ + +-+-+ +-+ + + + + + + + +-+ + + +-+-+-+ +-+-+-+ +
| | |   | |     |   |   |     | | |     |   | | | |       | | | | |   |   | |   | |       | |     | |
+ +-+ +-+ + +-+ + +-+-+-+-+-+ + + + +-+-+ +-+ + + +-+-+-+-+ + + + +-+-+-+-+ + +-+ +-+-+-+ +-+ +-+ + +
|     |   | |   |         |   | | |   |   |   |   |     |   | | |   |       |   | |   |     |   | | |
+-+-+-+ +-+ + +-+-+-+-+-+ + + + + +-+-+ +-+ +-+-+ + +-+ + + + + +-+ + +-+-+ +-+ + + + + + + +-+-+ +-+
|     |   | |   |       |   |   |   |     | | |   |   |   | | |     |   |   |   | | | | | | |   |   |
+ +-+-+-+ + +-+ + +-+-+ + +-+-+-+-+ + +-+ + + + +-+-+ +-+-+ + +-+-+-+-+-+ +-+ +-+ + +-+ +-+ + + +-+ +
|       | | |   |     | |   |   | |     |   |   |   |   | | | |   | |   |   |   |   |   |   | |     |
+-+-+-+ + + + +-+-+ +-+ +-+ + + + +-+-+ +-+-+-+-+-+ +-+ + + + +-+ + + + +-+ + +-+-+-+ +-+ +-+ + + +-+
|     | |   | |     |   | | | |   |       |         | | | | |   |   | | |   |         |   |   | |   |
+ +-+ + +-+-+ +-+-+-+ + + + + +-+-+ +-+-+ +-+ + +-+-+ + + + +-+ + +-+ + + +-+-+-+-+-+-+ + + +-+-+-+ +
| | | |     | |       |   | | |     |         |     |   | |   |     | |     |   |     | | | |       |
+ + + +-+-+ + + +-+-+-+-+-+ + + +-+-+-+-+ +-+-+-+-+-+ +-+ +-+ + + + + + +-+ + + + +-+ + + + +-+-+-+-+
| | |     | |     | |       |     |     | |   |       | | | | | | |   |   | | | | |   | | |   |   | |
+ + + + + + +-+ + + + +-+-+-+-+ + + +-+ + + + + +-+-+-+ + + + + +-+-+-+-+ + +-+ + +-+-+ + +-+ + + + +
|   | | | |   | | | |           |   |   | | |   | |     | | | |       |   |     |   | | |   | | |   |
+-+-+ +-+ + +-+ + + +-+-+-+-+-+-+-+-+ +-+ + +-+-+ + +-+-+ + + +-+-+-+ +-+-+-+-+ + + + + +-+ + + +-+ +
|   |   | |     |   |           |   |   | |   |   | |   |     | |   |         |   | | |   |   |   | |
+ + +-+ + +-+-+ +-+-+ + +-+-+-+ + +-+ + + +-+ + +-+ + + +-+ +-+ + + +-+-+-+-+ +-+-+ + +-+ +-+-+-+ + +
| |   | |       |   | |       | | |   | | |   | |   | |   |   |   |         | |   |   |         | | |
+ +-+ + +-+ +-+-+-+ + +-+-+-+ + + + +-+ + + +-+ +-+ + +-+ +-+ +-+-+-+-+-+-+ + + +-+-+ + +-+-+-+ + + +
| |   | | | |       |   | |   | |     | |   |     | |   |     |   |   |   |   |     |   |       | | |
+ +-+-+ + + + +-+-+-+-+ + + +-+ +-+-+-+ +-+-+ +-+ + +-+ +-+ +-+ + +-+ + +-+-+-+ +-+-+-+-+ +-+-+-+-+ +
|   |   |   | |   |   |   | |   |     |   |   |   | | |   | |   |     |     |             | |   |   |
+ + +-+-+-+-+ + +-+ + +-+ + + +-+-+ + + +-+ + + +-+ + +-+-+ +-+-+-+-+ +-+ + + + +-+ +-+-+-+ + + + + +
| |         |       |   | | |       |     | | | |   |     |       |     | | | |   |     |     |   | |
+-+-+-+ +-+ + +-+-+-+-+ + + +-+-+-+-+-+ + +-+ +-+ +-+ +-+ +-+ + + + +-+-+ +-+ +-+ +-+-+ + + +-+-+-+-+
|   |   |   | | |   | |   |   |   |     |   |   |       | |   | |   |   |     |   |     | |     |   |
+ +-+ +-+ +-+ + + + + +-+-+-+ + +-+ +-+-+-+ +-+ +-+-+-+ + +-+-+ +-+-+ + +-+-+-+ +-+ +-+-+ + +-+ +-+ +
|   |   |   | |   |       |   |   |   |   | |   |       |       |   | |     |     | | |   | |   |   |
+-+ +-+ + +-+ +-+-+-+-+-+ + +-+-+ +-+ + +-+ + +-+ + +-+-+-+-+-+-+ + + + +-+-+ +-+-+ + + + + + +-+ +-+
| | |   | |   |   |   | |       |     |     | |   | |   |   | |   |   |   |   |     |   | | | |   | |
+ + + +-+ + +-+-+ + + + +-+ +-+ +-+-+-+-+ +-+ + +-+-+ + +-+ + + +-+-+-+ + + +-+ +-+-+-+-+-+ + + +-+ +
|   |   |   | |   | |       | | |   |   |   | |     | |       | |   | | |   |   |           |       |
+ + +-+ +-+-+ + +-+ +-+ +-+-+ + +-+ + + +-+ + +-+-+ + +-+-+-+-+ + + + + +-+ + +-+ + +-+-+-+-+ +-+-+-+
| | | |       | |     |     | |     | |     | |   |   |       | | | | |   | |   | |     |   | |     |
+ + + +-+-+ +-+ + +-+-+-+-+ + +-+-+ +-+ +-+-+ + + +-+-+ +-+ + + +-+ + +-+ +-+-+ + +-+-+ + + +-+ +-+ +
| |         |           | |   |   | |   |     | | |   |   | | |   | |     |     |   |   | | |   |   |
+-+-+-+-+-+-+-+-+ +-+-+ + + +-+ + + + +-+ +-+-+ + + + +-+ + +-+-+ + +-+-+-+ +-+-+-+ + +-+ + + +-+ +-+
|   |           | |   |   |   | | | | |   |     |   |   | | |     |       |         |     |   |     |
+ +-+ +-+-+ +-+ + + +-+-+-+-+ + +-+ + + +-+ +-+-+-+-+ + + + + + +-+-+-+-+ +-+-+-+ +-+ +-+-+ +-+ +-+ +
|     |   | | |   |   |       | |   | | |   |       | |   | | | |   | |           | | |   | |   |   |
+-+-+-+-+ + + +-+-+-+ + +-+ + + + +-+ + + +-+ +-+-+ + +-+-+ + + +-+ + + + +-+-+-+-+ + + +-+ + +-+ +-+
|       | |       |   | |   | |   | | | | | |   | |   |     | |     |   |       | |   |     |   |   |
+ +-+-+ + + +-+-+ + +-+ + +-+-+-+ + + + + + +-+ + +-+-+ + +-+ +-+-+-+-+-+-+-+-+ + +-+-+-+-+-+ + +-+ +
| | |   | | |   | | |   | |   | |   | |   | |   |     | | | | |       |         | |   |       |   | |
+ + + +-+ +-+ + +-+ + +-+ +-+ + +-+-+ + + + + +-+-+-+ + + + + + +-+-+ +-+-+-+ +-+ +-+ + +-+-+-+-+ +-+
|   |     |   | |   |   | |   |     |   | |   |   |   | |   | | |   |   |     |   |   |   |     |   |
+-+ +-+-+-+ +-+ + +-+-+-+ + +-+ +-+ +-+-+ +-+-+ +-+ +-+-+-+-+ + + + +-+ +-+ +-+ +-+ + +-+ + +-+ +-+ +
|     |   |   |         | | |   |         |       |     |     | | |   |   | |   |   |   | |   |     |
+-+-+ + + +-+ +-+-+-+-+ + + +-+-+-+ +-+-+-+ +-+ + + +-+ + +-+-+ + +-+ +-+ + + +-+ +-+-+-+ +-+ +-+-+ +
|     | |   |       |   | | |   |   |     | |   | | |   |   | | | | |   |     | |         | | |   | |
+ +-+-+ +-+ +-+-+-+ + +-+ + + + + +-+ +-+ + + +-+ + +-+-+ + + + + + +-+ +-+ + + +-+ +-+-+-+ + + + + +
| |   | |   |       |   | |   | | |   | |   | |   |       | |   |   | |     |   | | |     |   | | | |
+ +-+ + + +-+ +-+-+-+-+-+ + +-+ + + +-+ +-+-+-+ +-+-+-+ +-+ +-+-+-+ + +-+-+-+-+-+ + + +-+ +-+-+-+ + +
|   | | |   |           |   |   |   | |         |     | | |     |   |           |     |   |     | | |
+-+ + + +-+ +-+-+-+-+-+ +-+-+ +-+-+-+ +-+-+ +-+-+-+-+ + + + + + +-+-+-+-+-+-+-+ +-+-+-+ +-+ + + + + +
|     |   | |         |     |     |         |     |   | |   | |       |     |     |     |   | |   | |
+ + +-+-+ + + +-+-+-+ +-+ + +-+ + +-+ +-+-+-+ +-+ + +-+ + +-+-+-+-+-+ + +-+ + +-+ + +-+-+ +-+-+-+-+ +
| |       | |   |   |     |     |   |       | |   | |   | | |         | | |   |   | |     |   |     |
+ +-+-+-+-+-+-+ + + +-+-+ +-+-+-+-+ +-+-+-+ +-+ +-+ + +-+ + + +-+-+-+-+ + +-+-+-+-+ + +-+-+ + + +-+-+
|   |           | |   |     |     |     | |   |   |   |     |       |   | |     |   | |     | | |   |
+-+ + +-+-+-+-+-+ +-+ +-+-+ + +-+-+-+ + + +-+ +-+ +-+ + +-+-+-+-+-+ + +-+ + +-+ + +-+ +-+-+-+ +-+ + +
|   |   |       |   |   |   | |       |     |     |   |   |         |     |   |   |       |     | | |
+ +-+-+ +-+-+-+ +-+ +-+ + +-+ + +-+-+-+-+ + +-+-+-+ +-+-+-+ +-+-+-+-+ + +-+-+ +-+-+ +-+-+ + +-+ + + +
| |   |       | | | | | |   |   |     |   | |     | |     |       |   | |   |     | |   | |   | | | |
+ + +-+-+-+ + + + + + + +-+ +-+-+ +-+ + +-+-+ +-+ +-+ +-+ +-+-+-+ + +-+ + +-+-+ + + +-+ + +-+-+ +-+ +
| |     |   | |     | |   |     | |   | |   | | | |   |   |   | |   |   |       |   |   | |         |
+ + + + + +-+-+-+-+ + +-+ +-+ +-+ + +-+ + + + + + + +-+ +-+ + + +-+-+ +-+-+-+ +-+-+-+ +-+ + +-+ +-+-+
|   | | |         |   | |     |   |   |   | | | | |   |   | |     | |       | |     | |     |   |   |
+-+-+-+ +-+-+ +-+ +-+ + + +-+-+ +-+-+ +-+-+ + + + +-+ +-+ + +-+-+ + +-+-+-+ +-+ +-+ + +-+-+-+ +-+ + +
| |           |   |   |   |   | |     |   | | | | | |   | |   | |   |   | | |   |   |   |   | |   | |
+ + +-+-+-+-+-+ +-+ +-+ +-+ +-+ + + +-+-+ + + + + + + + + +-+ + + +-+ + + + + +-+-+-+-+ + +-+ + +-+ +
| |     |   |   | |   | | |     | | |   | |   | | | | | | | | | |     |     |     |   | |       |   |
+ +-+-+ + + + +-+ + +-+ + +-+-+-+ + + + + + +-+ + + +-+ + + + + +-+-+-+-+ +-+-+-+ + + + +-+-+-+-+ +-+
|   |   | | | |   | |   | |     | | | | | | |   |       |   | |   |     | |   | | | | |     |   |   |
+-+ +-+ + + + + +-+ + +-+ +-+-+ + + + + + + + +-+-+ +-+-+ +-+ +-+ + +-+-+ +-+ + + + + +-+-+ + + +-+ +
| |     | | | | |   |     |   |   | | |   | | | |   |     |   | | | |     |       | |   |     | |   |
+ +-+-+-+ + + + + +-+-+-+-+ + + + + + +-+-+ + + + +-+ + +-+ +-+ + + + + +-+ + +-+-+ + + +-+-+-+ +-+ +
|         |   |             |   | |   |     |     |   |   |       |   |     |       | |       |     S
+-+-+-+-+-+-+-+-+-+-+-+-+-+-+-+-+-+-+-+-+-+-+-+-+-+-+-+-+-+-+-+-+-+-+-+-+-+-+-+-+-+-+-+-+-+-+-+-+-+-+