+-+-+-+-+-+-+-+-+-+-+-+-+-+-+-+-+-+-+-+-+-+-+-+-+-+
E   |       |   |   |                           | |
+-+ + +-+-+ +-+ + + +-+-+-+-+ +-+-+-+-+-+-+ +-+ + +
|   |   |   |   | |               |         |   | |
+ +-+-+ + +-+ +-+ +-+-+-+-+-+ +-+ + +-+-+-+-+-+ + +
| | |   |     |   |   |   |   |   |     | |     | |
+ + + +-+-+-+-+ +-+ + + + + +-+ +-+-+-+ + + +-+-+ +
|   |         | |   | | |   |   |       |   |     |
+-+ +-+ +-+-+ + + +-+ + +-+-+ +-+-+-+-+-+-+-+ +-+ +
|   |   |   | | | |   | |   |     |   |     |   | |
+ +-+ +-+ + + + + + +-+ + + +-+-+ + + +-+-+ +-+ +-+
|   | |   | | | | | | |   |     | | |     |   |   |
+ + + +-+ + +-+ + + + +-+-+-+-+-+ + +-+-+ +-+ +-+ +
| |   |   | |   | |   |     |     |     |   | |   |
+ +-+-+ +-+ + +-+-+ +-+-+-+ + +-+-+-+-+ +-+ + + +-+
| |     |   | |     |         |     |   | | | |   |
+ + +-+-+ +-+ + +-+-+ +-+-+-+-+ +-+ + +-+ + + +-+ +
|   |     |   | |   | |     |   | | |     | | |   |
+ +-+ + +-+ +-+ + + + + +-+ + +-+ + +-+-+-+ + + + +
|   | | |   |   | |   | |   |     | |           | |
+-+-+ +-+ +-+ +-+ +-+-+ + +-+-+-+-+ + +-+-+ +-+-+ +
|     |   |   |     |   |             |     |   | |
+ +-+-+ +-+ +-+-+ +-+ +-+-+-+-+-+-+-+-+-+-+-+ + + +
|   |   |   |   | |   |                       |   |
+-+ + +-+ +-+ + + + +-+ +-+-+-+-+-+-+-+-+-+-+-+-+-+
|     |   |   | |   |   |                   |     |
+-+ +-+ +-+ +-+-+-+-+ +-+ +-+-+-+-+-+-+-+-+ + +-+ +
|   |   |   | |     |   |     |         |   |   | |
+ +-+ +-+ +-+ + +-+ +-+ +-+-+ +-+-+-+-+ + +-+-+-+ +
| | | |         |       |     |           |     | |
+ + + +-+-+-+ +-+-+-+-+-+-+-+-+ +-+-+-+ +-+ + + + +
| |   |       | |     |   |   |       | |   | |   |
+ + +-+ +-+-+-+ + +-+ + + + + +-+ +-+ + + +-+ +-+-+
| | |   |   |   |   | | |   | |   | | | | |       |
+ + + +-+-+ + +-+-+ + + +-+ +-+ +-+ + + + +-+-+-+-+
|   |       |     | |     |   | |   | | |         |
+-+-+ +-+-+ + +-+ + +-+-+-+-+ + + +-+ +-+-+ +-+-+ +
|   | |     | |   |   |   | | |     |   |   |     |
+ + +-+ + +-+ + +-+-+ + + + + + + +-+-+ + +-+ +-+-+
| | |   | |   | |     | |     | | |     |   | |   |
+ +-+ +-+-+ +-+ + +-+-+ +-+-+-+ + + +-+-+-+ + + + +
|       |   |   | |     |       | | |       |   | |
+-+-+ + + +-+ +-+ + +-+-+ +-+-+-+ + + + +-+-+-+-+ +
|     |   |       |       |       | | |   |   |   |
+ +-+-+-+-+ + +-+-+-+-+-+-+ +-+-+-+ + +-+ +-+ + +-+
|   |       | |             |     | |   |   |   | |
+-+ +-+-+-+-+ +-+-+-+-+-+-+-+ +-+ + +-+-+-+ + +-+ +
| | |       | |   |     |     |     |   |   |   | |
+ + + +-+-+ +-+ + + +-+ + +-+-+ +-+-+ + + +-+ + + +
|   |     |     |   |         |       |   |   |   S
+-+-+-+-+-+-+-+-+-+-+-+-+-+-+-+-+-+-+-+-+-+-+-+-+-+