+-+-+-+-+-+-+-+-+-+-+
S |       |         |
+ + +-+-+ + + +-+-+-+
|   |   |   |       |
+-+-+ + +-+-+-+-+-+ +
| |   |         |   |
+ + +-+-+ +-+-+-+ +-+
| | |     |       | |
+ + +-+-+-+ +-+-+-+ +
| |     |     |     |
+ +-+-+ + +-+ + +-+-+
|     | |   |   |   |
+-+-+ + +-+ +-+-+ + +
|     | | | |   | | |
+ +-+-+ + + + + + + +
|   |   |     |   | |
+ + + +-+-+-+-+-+-+ +
| |   |         |   |
+ +-+-+ +-+-+-+ + + +
|       |         | E
+-+-+-+-+-+-+-+-+-+-+